%%%%%
%  P%
% % %
%   %
% %%%
% %%%
%.%%%
%%%%%